NO ./path_to_the_north_texture
SO ./path_to_the_north_texture
WE ./path_to_the_west_texture
EA ./path_to_the_east_texture

C 14,2,42
F 220,100,0
1111111111111111111111111
100000000N110000000000001
1000000000110000000000001
1000000000110000000000001
1110000011100000000000001
1111111111111111111111111