NO ./textures/diana.png
SO ./textures/64.png
WE ./textures/tkt.png
EA ./textures/josukeHigashikataDeLaPartie4.png

F 220,100,100
C 10,14,14


1111111111111111111111111
10000100001100000010000001
10010000001100000000000111
10011000000000000110000001
100000001000000000000000011
111000111111001111111111111
100000000000000N00000001
10000000000000000000111
111111111111100001111
            11111111