NO ./textures/diana.png
SO ./textures/diana.png
WE ./textures/josukeHigashikataDeLaPartie4.png
EA ./textures/josukeHigashikataDeLaPartie4.png

C 14,2,42
F 220,100,0
1111111111111111111111111
1000000000110000000000001
1000N00000110000000000001
1000000000110000000000001
1110000011100000000000001
1111111111111111111111111