NO ./textures/diana.png
SO ./textures/diana.png
WE ./textures/josukeHigashikataDeLaPartie4.png
EA ./textures/josukeHigashikataDeLaPartie4.png

C 14,2,42
F 220,100,0
1111111111111111111111111
10000100001100000010000001
100100000011000E00000000111
10011000000000000110000001
100000001000000000000000011
111000111111001111111111111
10000000100000000011111
100000000000000000001
111111111111100001111
           1000001
           111111