NO ./path_to_the_north_texture
SO ./path_to_the_north_texture
WE ./path_to_the_west_texture
EA ./path_to_the_east_texture

C 14,2,42
F 220,100,0
        1111111111111111111111111
        1000000000110000000000001
        1011000001110000000000001
        1001000000000000000000001
111111111011000001110000000000001
100000000011000001110111111111111111111
111101111111110111010100100000000000001
111101111111110111000000100000000000001
110000001101010111000000100000000000001
100000000000000011000001000000000000001111111111111111111111111111111111
100000000000000011010100100000000000001111111111111111
110000011101010111110111100000000000001111111111111111
11110111 1110101 1011110100000000000001
11111111 1111111 1111111111111111111111

        111
        101
        111
11111111111111111111111
1D1010D1010D1010D1010D1
11000000000000000000001
10000000000000000000001
110000N0000000000000001
10000000000000000000001
1D000000000000000000001
11000000000000000000001
10000000000000000000001
11000000000000000000001
10000000000000000000001
1D000000000000000000001
11000000000000000000001
10000000000000000000001
11000000000000000000001
10000000000000000000001
1D000000000000000000001
11000000000000000000001
10000000000000000000001
11000000000000000000001
10000000000000000000001
1D1010D1010D1010D1010D1
11111111111111111111111