NO ./textures/diana_text.png
SO ./textures/diana_text.png
WE ./textures/tkt_text.png
EA ./textures/tkt_text.png

F 220,155,0
C 14,14,14
1111111111111111111111111
10000100001100000010000001
100100000011000N00000000111
10011000000000000110000001
100000001000000000000000011
111000111111001111111111111
10000000100000000011111
100000000000000000001
111111111111100001111
           1000001
           111111